************************
*          *           *
*          *           *
*        *****         *
* **       *           *
*      *   *    ****** *
*      *               *
*      ********        *
*   *         *        *
*   *      * @         *
*****  *********   *****
*                      *
*          *           *
*        ********      *
* **                   *
*      *        ****** *
*      *               *
*      ********        *
*   *                  *
*   *      *           *
************************